********************
*..................*
*....**********....*
*..................*
*..................*
*....*.............*
*....*.............*
*....*.............*
*..................*
********************
