********************
*..................*
*........*.........*
*........*.........*
*....**********....*
*........*.........*
*........*.....*...*
*...*....*.........*
*...*..............*
********************
