********************
*..................*
*..................*
*..................*
*....**********....*
*..................*
*..................*
*..................*
*..................*
********************
